








NO       ./textures/wall.xpm
SO       ./textures/wall.xpm
EA      ./textures/wall.xpm
WE       ./textures/wall.xpm
F     62,44,     143   
C  90,             26,217         

1111111 
1001001111
10E0000001
1000110101
1111001001
1010000001
1010111111
10101
10001
10111
101
101
101
101
101
101
111
